█████████████
██         ██
██ █ █ █ █ ██
█■         ██
██ █ █ █ █ ██
██     █   ██
██ █ █ █ █ ██
██         F█
██ █ █ █ █ ██
██         ██
█████████████